9 9
	0	0	0	0	0	0	0	0	0
	0	8	7	6	0	0	0	0	0
	0	0	0	7	5	0	5	6	0
	0	0	0	0	0	0	0	2	0
	0	9	0	9	8	0	0	0	0
	1	2	0	0	0	0	0	3	4
	0	4	1	0	0	0	0	0	0
	0	3	0	0	0	0	0	0	0
	0	0	0	0	0	0	0	0	0
