9 9
	0	0	0	0	0	0	0	0	0
	0	2	0	0	2	0	3	4	0
	5	3	0	0	0	0	0	0	0
	0	0	7	4	0	0	0	0	0
	0	0	0	0	0	0	0	0	6
	0	0	1	0	0	1	6	0	0
	0	0	8	0	0	0	0	0	0
	0	0	0	0	0	0	8	5	0
	0	0	0	0	7	0	0	0	0
