13 13
	0	0	0	0	0	0	0	0	0	0	0	0	0
	0	0	0	0	0	0	0	0	0	0	0	0	0
	6	0	0	0	5	0	0	0	0	0	11	0	0
	0	0	0	2	8	0	1	0	0	7	0	0	0
	0	0	0	0	0	0	0	0	7	0	0	0	0
	0	0	12	0	0	0	0	0	0	0	0	0	1
	0	0	0	0	0	0	0	0	0	11	0	3	0
	0	0	0	0	0	0	0	0	0	0	0	0	0
	0	0	0	0	0	0	0	0	0	0	0	0	0
	0	9	0	0	0	8	0	3	4	0	0	4	0
	0	0	0	12	0	0	0	0	0	0	0	0	0
	0	9	0	0	5	0	0	0	0	0	2	6	0
	0	0	0	0	0	0	0	0	0	0	0	0	0
