11 11
	0	0	0	0	0	0	0	0	0	0	0
	0	0	0	0	0	0	4	0	11	0	7
	0	0	0	0	0	0	12	0	5	0	0
	0	12	4	6	0	0	0	0	0	0	0
	0	0	10	0	0	0	0	0	6	0	0
	0	10	0	0	0	0	0	0	0	0	0
	0	5	0	0	0	0	0	0	0	1	0
	0	2	0	0	7	0	0	11	0	0	0
	0	0	0	0	0	2	0	9	0	0	0
	1	0	0	0	0	0	0	3	0	0	9
	8	0	0	0	0	0	0	0	8	0	3
