7 7
	0	0	3	6	0	0	0
	0	0	5	2	0	0	0
	0	0	4	1	0	0	0
	0	0	0	4	0	2	0
	0	0	1	0	0	5	6
	0	0	0	0	0	0	3
	0	0	0	0	0	0	0
